100
100
1111111111111111111111111111111111111111111111111111111111111111111111111111111111111111111111111111
1111111111111111111111111111111111111111111111111111111111111111111111111111111111111111111111111111
1111111111111111111111111111111111111111111111111111111111111111111111111111111111111111111111111111
1111111111111111111111111111111111111111111111111111111111111111111111111111111111111111111111111111
1111111111111111111111111111111111111111111111111111111111111111111111111111111111111111111111111111
1111111111111111111111111111111111111111111111111111111111111111111111111111111111111111111111111111
1111111001100110011001100110011001100110011001101111011001100110011001100110011001100110011001111111
1111111001100110011001100110011001100110011001101111011001100110011001100110011001100110011001111111
1111100000000000000000000000000000000000000000001111000000000000000000000000000000000000000000011111
1111100000000000000000000000000000000000000000001111000000000000000000000000000000000000000000011111
1111111000000000000000000000000000000000000000001111000000000000000000000000000000000000000001111111
1111111000000000000000000000000000000000000000001111000000000000000000000000000000000000000001111111
1111100000000000000000000000000000000000000000001111000000000000000000000000000000000000000000011111
1111100000000000000000000000000000000000000000001111000000000000000000000000000000000000000000011111
1111111000000000000000000000000000000000000000001111000000000000000000000000000000000000000001111111
1111111000000000000000000000000000000000000000001111000000000000000000000000000000000000000001111111
1111100000000000000000000000000000000000000000001111000000000000000000000000000000000000000000011111
1111100000000000000000000000000000000000000000001111000000000000000000000000000000000000000000011111
1111111000000000000000000000000000000000000000001111000000000000000000000000000000000000000001111111
1111111000000000000000000000000000000000000000001111000000000000000000000000000000000000000001111111
1111100000000000000000000000000000000000000000001111000000000000000000000000000000000000000000011111
1111100000000000000000000000000000000000000000001111000000000000000000000000000000000000000000011111
1111111000000000000000000000000000000000000000001111000000000000000000000000000000000000000001111111
1111111000000000000000000000000000000000000000001111000000000000000000000000000000000000000001111111
1111111111111100111111111111111111111111111111111111000000000000000000000000000000000000000000011111
1111111111111100111111111111111111111111111111111111000000000000000000000000000000000000000000011111
1111111000000000000000000000000000000000000000001111000000000000000000000000000000000000000001111111
1111111000000000000000000000000000000000000000001111000000000000000000000000000000000000000001111111
1111100000000000000000000000000000000000000000001111000000000000000000000000000000000000000000011111
1111100000000000000000000000000000000000000000001111000000000000000000000000000000000000000000011111
1111111000000000000000000000000000000000000000001111000000000000000000000000000000000000000001111111
1111111000000000000000000000000000000000000000001111000000000000000000000000000000000000000001111111
1111100000000000000000000000000000000000000000001111000000000000000000000000000000000000000000011111
1111100000000000000000000000000000000000000000001111000000000000000000000000000000000000000000011111
1111111000000000000000000000000000000000000000001111000000000000000000000000000000000000000001111111
1111111000000000000000000000000000000000000000001111000000000000000000000000000000000000000001111111
1111100000000000000000000000000000000000000000000000000000000000000000000000000000000000000000011111
1111100000000000000000000000000000000000000000000000000000000000000000000000000000000000000000011111
1111111000000000000000000000000000000000000000001111000000000000000000000000000000000000000001111111
1111111000000000000000000000000000000000000000001111000000000000000000000000000000000000000001111111
1111100000000000000000000000000000000000000000001111000000000000000000000000000000000000000000011111
1111100000000000000000000000000000000000000000001111000000000000000000000000000000000000000000011111
1111111000000000000000000000000000000000000000001111000000000000000000000000000000000000000001111111
1111111000000000000000000000000000000000000000001111000000000000000000000000000000000000000001111111
1111100000000000000000000000000000000000000000001111000000000000000000000000000000000000000000011111
1111100000000000000000000000000000000000000000001111000000000000000000000000000000000000000000011111
1111111000000000000000000000000000000000000000001111000000000000000000000000000000000000000001111111
1111111000000000000000000000000000000000000000001111000000000000000000000000000000000000000001111111
1111100000000000000000000000000000000000000000001111000000000000000000000000000000000000000000011111
1111100000000000000000000000000000000000000000001111000000000000000000000000000000000000000000011111
1111111000000000000000000000000000000000000000001111000000000000000000000000000000000000000001111111
1111111000000000000000000000000000000000000000001111000000000000000000000000000000000000000001111111
1111100000000000000000000000000000000000000000001111000000000000000000000000000000000000000000011111
1111100000000000000000000000000000000000000000001111000000000000000000000000000000000000000000011111
1111111000000000000000000000000000000000000000001111000000000000000000000000000000000000000001111111
1111111000000000000000000000000000000000000000001111000000000000000000000000000000000000000001111111
1111100000000000000000000000000000000000000000001111000000000000000000000000000000000000000000011111
1111100000000000000000000000000000000000000000001111000000000000000000000000000000000000000000011111
1111111000000000000000000000000000000000000000001111000000000000000000000000000000000000000001111111
1111111000000000000000000000000000000000000000001111000000000000000000000000000000000000000001111111
1111100000000000000000000000000000000000000000001111000000000000000000000000000000000000000000011111
1111100000000000000000000000000000000000000000001111000000000000000000000000000000000000000000011111
1111111000000000000000000000000000000000000000001111000000000000000000000000000000000000000001111111
1111111000000000000000000000000000000000000000001111000000000000000000000000000000000000000001111111
1111100000000000000000000000000000000000000000001111000000000000000000000000000000000000000000011111
1111100000000000000000000000000000000000000000001111000000000000000000000000000000000000000000011111
1111111000000000000000000000000000000000000000001111000000000000000000000000000000000000000001111111
1111111000000000000000000000000000000000000000001111000000000000000000000000000000000000000001111111
1111100000000000000000000000000000000000000000001111000000000000000000000000000000000000000000011111
1111100000000000000000000000000000000000000000001111000000000000000000000000000000000000000000011111
1111111000000000000000000000000000000000000000001111000000000000000000000000000000000000000001111111
1111111000000000000000000000000000000000000000001111000000000000000000000000000000000000000001111111
1111100000000000000000000000000000000000000000001111000000000000000000000000000000000000000000011111
1111100000000000000000000000000000000000000000001111000000000000000000000000000000000000000000011111
1111111000000000000000000000000000000000000000001111000000000000000000000000000000000000000001111111
1111111000000000000000000000000000000000000000001111000000000000000000000000000000000000000001111111
1111100000000000000000000000000000000000000000000000000000000000000000000000000000000000000000011111
1111100000000000000000000000000000000000000000000000000000000000000000000000000000000000000000011111
1111111000000000000000000000000000000000000000001111000000000000000000000000000000000000000001111111
1111111000000000000000000000000000000000000000001111000000000000000000000000000000000000000001111111
1111100000000000000000000000000000000000000000001111000000000000000000000000000000000000000000011111
1111100000000000000000000000000000000000000000001111000000000000000000000000000000000000000000011111
1111111000000000000000000000000000000000000000001111000000000000000000000000000000000000000001111111
1111111000000000000000000000000000000000000000001111000000000000000000000000000000000000000001111111
1111100000000000000000000000000000000000000000001111000000000000000000000000000000000000000000011111
1111100000000000000000000000000000000000000000001111000000000000000000000000000000000000000000011111
0110011000000000000000000000000000000000000000001111000000000000000000000000000000000000000001111111
0110011000000000000000000000000000000000000000001111000000000000000000000000000000000000000001111111
0000000000000000000000000000000000000000000000001111000000000000000000000000000000000000000000011111
0000000000000000000000000000000000000000000000001111000000000000000000000000000000000000000000011111
0000000000000000000000000000000000000000000000001111000000000000000000000000000000000000000001111111
0000000000000000000000000000000000000000000000001111000000000000000000000000000000000000000001111111
0000000000000000000000000000000000000000000000001111000000000000000000000000000000000000000000011111
0000000000000000000000000000000000000000000000001111000000000000000000000000000000000000000000011111
0110011001100110011001100110011001100110011001101111011001100110011001100110011001100110011001111111
0110011001100110011001100110011001100110011001101111011001100110011001100110011001100110011001111111
1111111111111111111111111111111111111111111111111111111111111111111111111111111111111111111111111111
1111111111111111111111111111111111111111111111111111111111111111111111111111111111111111111111111111
1111111111111111111111111111111111111111111111111111111111111111111111111111111111111111111111111111
1111111111111111111111111111111111111111111111111111111111111111111111111111111111111111111111111111
