50
40
01001000011111110000001000001000010010010000000000
00100100010111011101001101011110011010010000000011
00010011110111011010111101100010001010010100001000
00001000110111111100010010010001011100010000000000
00000000000000000000000011111111111000011100000000
00000000000000000000000000000000000000000000100000
00000011111111111100000000000000000000000000000010
00000001111111010010000000000000000000000000000010
00000111111111110010000000000000000110000000000000
10001111100111011111100000000111110110000000000000
00001110100111111100111111100111111000000001100000
00001100000111110110011111111110001110100001100000
11001110000001110011000001111010001111001010000000
00011011111100111111100000000010100111101010000111
00011101111100111011100000000011001100111010000011
00001100111101111111000000000001111000011011111010
00000000000000111100000000000000000000000001111110
00000001100000111111000000000111110000000000111100
00000001100000111011101100001100011000000111111000
00000001000000011100111111101000001111101100010000
00000001000000001110000110101000000011101111100000
00000111111000000110000000010110111110000000111100
00011000001111000110000000011110111010000000100010
00010000000000100000000000000010111000000000100001
00010000000000100110000000000010111100001001101100
00010000000000100110000000000111111111111001101100
00011000000000101110000000000000011111111001110000
10011000000000101110000000000111110000011001111111
11111000000001101110101000000100000000001001111111
01111100111111101111101000000000000011111001001111
11111100111111011111000100000001111110001001000000
10011100111100011111101100111111000000111001000100
00011100100111010001101001111000000011100000000110
00001100110111110000101011011000000110000000000011
00000000011111100011101110000000000100000000000000
00000000001111100100101000000000000100000000000000
00000001000000011000000000000000000100000000000000
00000011110011111000000011000000000100000000000000
00001111111110011100000011000000000100000000000000
00010000000000011000001100000000010110000000000000
