50
40
01001000011111110000001000001000010010010000000000
00100100010111011101001101011110011010010000000011
00010011110111011010111101100010001010010100001000
00001000110111111100010010010001011100010000000000
00000000000000000000000011111111111000011100000000
00000000000000000000000000000000000000000000100000
00000011111111111100000000000000000000000000000010
00000001111111010010000000000000000000000000000010
00000111111111110010000000000000000000000000000000
10001111100111011111100000000111110000000000000000
00001110100111111100110000000111111000000000000000
00001100000111110110011111001110001110000000000000
11001110000001110011000001111010001111001010000000
00011011111100111111100000000010100111101010000111
00010000111100111011100000000011001100111010000011
00000000111101111100000000000001111000011111111010
00000000000000111100000000000000000000000001111110
00000000000000111110000000000000000000000000111100
00000000000000111000000000000000000000000000000000
00000000000000011100000000000000000000000000000000
00000000000000001110000000000000000000000000000000
00000000000000000110000000000000000000000000000000
00000000000000000110000000000000000000000000000000
00000000000000000000000000000000000000000000000000
00000000000000000110000000000000000000000000000000
00000000000000000110000000000000000000000000000000
00000000000000001110000000000000000000000000000000
10000000000000001110000000000000000000000000000000
11000000000000001110000000000000000000000000000000
01110000000000001111000000000000000000000000000000
11110000000000011111000000000000000000000000000000
10010000000000011111100000000000000000000000000000
00010000100000010001100000000000000000000000000000
00001100110000110000100000000000000000000000000000
00000000011000100011100000000000000000000000000000
00000000001111100100000000000000000000000000000000
00000001000000011000000000000000000000000000000000
00000011110011111000000000000000000000000000000000
00001111111110011100000000000000000000000000000000
00010000000000011000000000000000000000000000000000
